*************
* * * *     *
* *   * *** *
*  S***     *
* *    G*** *
* * *** *   *
* * *   *** *
* * *** * * *
*         * *
*************

