*************
* * * *     *
* *   * *** *
*  S***     *
* *     *** *
* * *** *   *
* * *   *** *
* * *** * * *
*         *G*
*************

