*************
* * * *     *
* *   * *** *
*  S***  G  *
* *     *** *
* * *** *   *
* * *   *** *
* * *** * * *
*         * *
*************

